AT		AT
AY		AY
BEYBEH	BEYBEH
GAWA	GAWA
GAWIN	GAWIN
HABA 	HABA
HABANG	HABANG
HINDI	HINDI
ITO		ITO
ILABAS	ILABAS
KUNG	KUNG
MALAKI	MALAKI
MALI	MALI
MALIIT	MALIIT
MAS		MAS
MO		MO
NA 		NA
NG		NG
O		O
PANTAY	PANTAY
PAREHO	PAREHO
PATI	PATI
PERO 	PERO
SA		SA
TAMA	TAMA
!		TERMINATOR
"		DQUOTE
.		PERIOD
+		PLUS
-		MINUS
*		MULT
/		DIVIDE
%		MODULO
^		EXP
\		SLASH
(		LPAREN
)		RPAREN